1111111
1P00001
1CC0001
1CC0001
1E000S1
1111111